Burt Gummer|Michael Gross|Tremors|current
Nancy Sterngood|Charlotte Stewart and Marcia Strassman|Tremors|current
Jodi Chang|Susan Chuang and Lela Lee|Tremors 3: Back to Perfection|current
Tyler Reed|Victor Browne|Tremors: The Series|current
Rosalita Sanchez|Gladise Jimenez|Tremors: The Series|current
Larry Norvel|J. D. Walsh|Tremors: The Series|current
Mindy Sterngood|Ariana Richards and Tinsley Grimes|Tremors|sometime
Cletus Poffenberger|Christopher Lloyd|Tremors: The Series|sometime
Harlow Winnemuca|Branscombe Richmond|Tremors: The Series|sometime
Valentine McKee|Kevin Bacon|Tremors|previous
Earl Bassett|Fred Ward|Tremors|previous
Heather Gummer|Reba McEntire|Tremors|previous
Melvin Plug|Robert Jayne|Tremors|previous
Miguel|Tony Genaro|Tremors|previous|dead
Desert Jack Sawyer|Shawn Christian|Tremors 3: Back to Perfection|previous
Buford|Billy Rieck|Tremors 3: Back to Perfection|previous|dead
Rhonda LeBeck|Finn Carter|Tremors|scientific community
Dr. Andrew Merliss|Barry Livingston|Tremors 3: Back to Perfection|scientific community|dead
Dr. Harold Baynes|Matt Malloy|Tremors: The Series|scientific community
Donna Debevic|Joan McMurtrey|Tremors: The Series|scientific community
Dr. Megan Flint|Melinda Clarke|Tremors: The Series|scientific community
Roger Garret|Richard Biggs|Tremors: The Series|scientific community
Dr. Casey Mathews|Sarah Rafferty|Tremors: The Series|scientific community
Pete Norris|Danny Hitt|Tremors: The Series|scientific community
Otto Thurman|Tom Mccafferty|Tremors: The Series|scientific community
Grady Hoover|Christopher Gartin|Tremors II: Aftershocks|other
Kate 'White' Reilly|Helen Shaver|Tremors II: Aftershocks|other
Agent Charlie Rusk|John Pappas|Tremors 3: Back to Perfection|other
W.D. Twitchell|Dean Norris|Tremors: The Series|other
Julio|Marco Hernandez|Tremors II: Aftershocks|other|dead
Señor Ortega|Marcelo Tubert|Tremors II: Aftershocks|other|dead
Pedro|José Ramón Rosario|Tremors II: Aftershocks|other|dead