Beverly Hills, 90210|The Back Story
The X-Files (1993)
Space: Above and Beyond|Ray Butts
Buffy the Vampire Slayer (1997)|School Hard
Nash Bridges|Power Play
That '70s Show|Eric Gets Suspended
Becker|Santa On Ice
Malcolm in the Middle|Stock Car Races
Special Unit 2|The Grain
Touched by an Angel|Song for My Father
ER|Beyond Repair.
Jake 2.0|Arms and the Girl
Cold Case|The Plan
Everybody Hates Chris|Everybody Hates Playboy
Huff|Radio Silence
CSI: Crime Scene Investigation
Criminal Minds|North Mammon
Prison Break|Bolshoi Booze
Breaking Bad|Pilot
Medium|To Have and to Hold
New Amsterdam|Love Hurts
Reaper|The Devil and Sam Oliver
Saving Grace|It's a Fierce, White-Hot, Mighty Love
Sordid Lives: The Series|Pills, Poison and Penises
Burn Notice|Scatter Point
Pushing Daisies|Bad Habits
Heroes|One of Us, One of Them
Californication|The Raw & the Cooked
United States of Tara pilot
24|Day 8: 9:00 p.m. â€” 10:00 p.m.
American Horror Story: Murder House|Birth
Lost|LA X
Justified|Riverbrook
NCIS|Freedom
The Middle|The Map
Shameless|I'll Light a Candle for You Every Day
Warehouse 13|The Ones You Love
The World's End
Kingdom|Please Refrain from Crying
The Walking Dead|Save the Last One
Twin Peaks (2017)|Part 5
Wisdom of the Crowd|Root Directory
Shooter|Red Meat
The Blacklist|Robert Vesco
